037BBBBBBBBBBBFBBBBBF
C25955555551535955537
CA5A6AAAAA8A4A1A6ACA7
DA5A595555565C565B5A7
DA5A5A2AAAEABAAA9A5A7
DA5A5C5553595555565A7
DA5A7AEA8A5A2AAAAA9A7
DA5A5B595658555555567
DA5A1A5A6ADA2AAAEAAAF
DA5C565A5B5C555359537
DA7AAADA5A3AEA8A5A4A7
DA59535A585359565A5A7
DA1A4A1A5A4A1A2A9A5A7
DC565C565E5C5455565A7
FEEEFEEEFEFEEEEEEEDA7

0,0
19,14
SESSSSSSSSSSSSEENNEESSEENNNNNNEENNWWWWNNEEEEEENNEESSEENNEEEESSSSSSWWWWWWWWSSEEEESSWWSSEEEENNNNEESSSSS
