037BBBFBBBBBBBBBFBBBBBBBBBBBFBF
C2595759555155535D55515555535B7
CA5A6A9A6ACA6A8A3AAA8A6AAACA5A7
DA5A59565B5A5D5455555659535A5A7
DA5A1A6A9A5A3AAAAAAAAADA4A5A5A7
DA585659565C55555555535A5A5A5A7
DA5A2ADA2ABAEAAAAAAA8A5A5A5A1A7
DA5C535C555359555555565A5E5C527
DA7A8A7AAA8A5A2AEAAAEA9A3ABACA7
DA59565955525C535953595451575A7
DA5A2A9A6ACA3ACA5A4A1A6ACA2ADA7
DA5C55565B58575A5A5C565B5C535A7
DA7AAAAA9A5A6A9A5A3AAA9A3ACA1A7
DA5D5551525A59565C555554535C567
DA3AAACA4A1A5A6ABAAAEAAACA7AAAF
DC55535E5C565A59515759535A59537
FAAACA7ABAAA9A5A4A2ADA4A1A5A4A7
DD535A595555565A5C535A5C565A5A7
FA8A5A5A6AEAAADA3ACA5A7AAA9A5A7
D9565A5A5B595358575A5A5D51565A7
DA6A9A5A5A1A4A5A6A9A5A3A8A6ADA7
DA59565A5C565A5A59565C55565B5A7
DA5A2A9A7AAA9A5A5A2ABAAAAA9A5A7
DA5C55565955565A5C55555155565A7
DA7AAAAA9A6AAA9A7AAAEACA2AAA9A7
DA5955555259555659535B5C5555567
DA1A6AEA8A5A2AEA9A4A5A3AAAEAAAF
D8565B59565C535D525A58555359537
DA2A9A5A2ABA8A3A8A5A1A6A8A1A4A3
DC55565C55555455565C565D5456583
FEEEEEFEEEEEEEEEEEFEEEFEEEEEDC0

0,0
30,30
SESSSSSSSSSSSSSSEEEESSSSSSWWSSEEEENNNNNNEEEEEENNNNEENNNNWWNNEEEEEEEENNWWWWWWWWWWNNNNEEEESSEEEEEENNEEEEEESSSSSSEESSSSSSWWNNWWNNWWWWSSWWNNWWSSSSEEEEEEEESSSSWWNNWWSSSSSSEEEENNEENNNNEESSSSSSSSSSWWWWWWNNWWWWWWNNEENNNNWWNNWWSSSSSSSSSSWWWWSSEESSEEEENNNNEESSSSEENNEEEESSEENNEESSSE
