B3BBBBFBBBBBBBBBFBBBBBFBBBBBFBF
C555535D515555535955575951535B7
EAAACA3A8A6AAACA5A2AAA9A4A4A1A7
D9575C555659535A585555565A5C527
DA2ABAAAAA9A4A5A5A2AAAAADA7ACA7
D855555555565A5A5C5555535A5B5A7
DA2AEAEAAAAA9A5A3AAAEACA5A5A1A7
DC535B595555565C55535B5A5A58567
FACA5A5A2AAAAAFAAA8A5A1A5A5A2AF
DB5A5A5C5555535955565C525A5C577
DA5A5A3AEEEA8A5A6EEEFECA5A3AAAF
DA5A58537FD9565A7FFFFFDA5C55537
DA5A1A4A7FDA2A9A3BBBFFDA7AEA8A7
DA5C565A7FDC555455577FDA5B59567
DA3AAADA7FFEEEEAEEEEFFDA1A5A2AF
D851535A7FFFFFDB7FFFFFDC525C537
DA4A4A5A7BBBFFDA7FFBBBBA8A3ACA7
DA5A5E5A59537FDA7FDD555554575A7
DA5A7A9A5A4A7FDA7FFEEEEAAAAADA7
DA5A59565E5A7FDA7FFFFFD955535A7
DA5A5A2ABA9A7B9A3BBBBB9A6ACA1A7
DE5A5C5555525954515555565B5C527
FA9A3AEAAA8A5A2ACA2AAAAADA3ACA7
D954575955565C535C55555358535A7
DA2AAADA2AAAFA8A3AAAEA8A5A4A1A7
D855535C55535D54555359565A5C567
DA6ACA3AEA8A7AAAEA8A5A6ADA3AAAF
DA5B5C53595659535D565A5B5C55537
DA1A3ACA1A2A9A4A3AAA9A5A3AAA8A3
DC54575C5455565C5555565C5555543
FEEEEEFEEEEEEEFEEEEEEEFEEEEEECE

0,0
30,30
SEEEEESSEEEENNEEEEEESSSSSSEEEESSWWWWSSSSWWWWNNEENNWWWWWWNNEEEEEENNNNWWSSWWWWWWWWWWSSEESSSSSSEENNEESSSSSSSSWWSSEEEEEESSWWWWSSEEEESSWWSSEEEENNEESSEEEEEENNNNEENNWWWWWWNNEEEEEENNEEEESSEESSSSWWNNWWSSSSEEEESSES
